R---R---R--R---
-R-RR-RRRRRRRR-
-R-----R-----RR
RR-RRR-R-RRR-R-
-----R-RvR-----
-R---R-R-R-RRR-
-R-RRR-RRRR----
RR---R-R-R-R-R-
-RRR-R-R-R-R-RR
-----R-R-R-R-R-
-R-RRR-R-RRR---
-R-----------R-
R*R---RR--R--RR
--RRR-RRR-RR-R-
--------R--R---
