---------
-RvRRRRR-
RRRRRR--R
R---RRRR-
--R-R-R-R
-RR---R--
RRRRRR-RR
-*R---R--
R-------R
